9 4 4 9 9 2 0 0 1 0 0 1 0 0 3 9 4 9 4 9
9 5 4 9 9 2 0 0 1 0 0 1 0 0 3 9 7 9 4 4
9 6 9 9 9 2 0 0 1 0 0 1 0 0 3 9 8 9 9 9
9 9 9 9 9 2 0 0 1 0 0 1 0 0 3 9 9 4 9 4
9 9 7 9 4 2 0 0 1 0 0 1 0 0 3 9 9 9 4 9
9 9 8 4 9 2 0 0 1 0 0 1 0 0 3 9 9 9 9 9
4 9 9 9 5 2 0 0 1 0 0 1 0 0 3 9 9 4 9 9
9 9 9 9 6 2 0 0 1 0 0 1 0 0 3 9 9 9 5 9
9 4 9 9 9 2 0 0 1 0 0 1 0 0 3 9 9 4 6 9
9 9 9 9 9 2 0 0 1 0 0 1 0 0 3 7 9 9 4 9
9 9 9 7 9 2 0 0 1 0 0 1 0 0 3 8 9 9 9 9
4 9 9 8 9 2 0 0 1 0 0 1 0 0 3 9 4 9 4 9
9 5 9 9 9 2 0 0 1 0 0 1 0 0 3 9 5 9 9 9
9 6 9 4 9 2 0 0 1 0 0 1 0 0 3 9 6 9 9 9
9 4 9 9 9 2 0 0 1 0 0 1 0 0 3 9 9 9 9 9
9 9 9 4 9 2 0 0 1 0 0 1 0 0 3 4 9 7 9 4
9 9 9 9 9 2 0 0 1 0 0 1 0 0 3 9 9 8 9 9
9 7 4 5 9 2 0 0 1 0 0 1 0 0 3 9 9 9 4 9
9 8 9 6 4 2 0 0 1 0 0 1 0 0 3 5 9 9 9 4
9 9 4 9 9 2 0 0 1 0 0 1 0 0 3 6 9 9 4 9
9 9 9 9 9 2 0 0 1 0 0 1 0 0 3 9 9 9 9 9
